40
22
15
1
WWWWWWWWWWWWWWWWWWWWWWWWWWWWWWWWWWWWWWWW
W         d r      r r            r    W
W rXr                rd  r             W
W             r     r r  r        r    W
Wr rr         r      r  r    r   r     W
Wr  r          r  r        r      r rr W
W      r        r     r  r        r rr W
Wwwwwwwwwwwwwwwwwwwwwwwwwwwwwww   r  r W
W     r  d    r r          d rd        W
W  d     r              rr r  r    r   W
W   r  r r              r  r  r        W
W r     r        rrr       r    d    r W
W d     r        r rd  d    r   r  d   W
W  r              r r  r        d     rW
W        wwwwwwwwwwwwwwwwwwwwwwwwwwwwwwW
W r         r   d    r     r   r       W
W r          r  r        r      r rr  PW
W    r        r     r       d   r rr   W
W    rd  r        r      r rd      r   W
W      r    r rr         r rd         rW
W d                      r  r    r   r W
WWWWWWWWWWWWWWWWWWWWWWWWWWWWWWWWWWWWWWWW