40
22
12
2
WWWWWWWWWWWWWWWWWWWWWWWWWWWWWWWWWWWWWWWW
W.....X................................W
W......................................W
W......................................W
W......................................W
W......................................W
W......................................W
W......................................W
W................ q....................W
W......................................W
W......................................W
W......................................W
W......................................W
W......................................W
W......................................W
W......................................W
W......................................W
W......................................W
W......................................W
W......................................W
W......................................P
WWWWWWWWWWWWWWWWWWWWWWWWWWWWWWWWWWWWWWWW
