40
22
12
2
WWWWWWWWWWWWWWWWWWWWWWWWWWWWWWWWWWWWWWWW
W....BX................................W
W......................................W
W......................................W
W................. r...................W
W................. ....................W
W................. ....................W
W................. ....................W
W.................q ...................W
W.................  ...................W
W......................................W
W......................................W
W......................................W
W......................................W
W......................................W
W......................................W
W......................................W
W......................................W
W......................................W
W......................................W
W......................................P
WWWWWWWWWWWWWWWWWWWWWWWWWWWWWWWWWWWWWWWW
