40
22
15
1
WWWWWWWWWWWWWWWWWWWWWWWWWWWWWWWWWWWWWWWW
W                                      W
W                                      W
W                                      W
W                                      W
W                                      W
W                                      W
W                                      W
W                                      W
W                                      W
W                                      W
W                                      W
W                                      W
W                                      W
W                                      W
W                                      W
W                                      W
W                                      W
W                                      W
W                                      W
W         Xd                   r       W
WWWWWWWWWWWWWWWWWWWWWWWWWWWWWWWWWWWWWWWW